Funkytown - Lipps Inc.
The Hustle- Van McCoy & The Soul City Symphony
Kung Fu Fighting- Carl Douglas
Get Down - Gene Chandler
You're The First, The Last, My Everything - Barry White
You To Me Are Everything- The Real Thing
Casanova - Coffee
Don't Stop The Music -Yarbrough & Peoples
Shake Your Groove Thing - Peaches & Herb
You Gave Me Love- Crown Heights Affair
Behind The Groove - Teena Marie
Let's Get Serious - Jermaine Jackson
Let It Whip - Dazz Band
Don't Leave Me This Way - Thelma Houston
I Love The Nightlife (Disco 'Round) - Alicia Bridges
If I Can't Have You- Yvonne Elliman
It Only Takes A Minute -Tavares
Upside Down - Diana Ross
Knock On Wood- Amii Stewart
Super Freak- Rick James
I Feel Sanctified - Commodores
Can't Get Enough Of Your Love, Babe - Barry White
Give It To Me Baby - Rick James
Dancesucker- Set The Tone
Walking Into Sunshine - Central Line
More Than A Woman - Tavares
British Hustle - Hi-Tension
Heart Of Glass - Blondie
Voulez-Vous- Abba
Guilty - Mike Oldfield
Slow Down - John Miles
I Love America - Patrick Juvet
Love's Theme - The Love Unlimited Orchestra
Take Me Home - Cher
Gimme! Gimme! Gimme! (A Man After Midnight)- Abba
I'm On Fire- 5000 Volts
Call Me- Blondie
I'm Coming Out - Diana Ross
I Need A Man - Grace Jones
Heaven Must Be Missing An Angel - Tavares
Starchild - Level 42
Nature Boy- Central Line
In My House - Mary Jane Girls
The Boss - Diana Ross
I'm So Glad That I'm A Woman - Love Unlimited
Let The Music Play - Barry White
Get It Up For Love - Tata Vega
Brick House - Commodores
The Grunt - The J.B.'s
Cross The Tracks (We Better Go Back) - Maceo And The Macks
I Believe In Miracles - Jackson Sisters
My Old Piano - Diana Ross
Adventures In Paradise - Minnie Riperton
Let's Start The Dance - Bohannon
Don't Push It Don't Force It- Leon Haywood
Running Away - Roy Ayers
Soul Makossa - Manu Dibango
All Night Long - Mary Jane Girls
Machine Gun - Commodores
Walk The Night - Skatt Bros
Make It Funky - James Brown
Monkey Chop - Dan I
Contact - Edwin Starr
The Shuffle - Van McCoy & The Soul City Symphony
Disco Connection - Isaac Hayes
Walking In Rhythm- The Blackbyrds
Love Hangover - Diana Ross
You See The Trouble With Me - Barry White
(You Know) You Can Do It- Central Line
Turn It On - Level 42
Strange Game And Things - Love Unlimited Orchestra
Althea & Donna - Uptown Top Ranking
Anita Ward - Ring My Bell
M - Pop Muzik
Lipps Inc. - Funky Town
Michael Sembello - Maniac
Thelma Houston - Don't Leave Me This Way
The Andrea True Connection - More More More
Dan Hill - Sometimes When We Touch
Charlene - I've Never Been to Me
David Parton - Isn't She Lovely
John Paul Young - Love Is In The Air
Rachel Sweet - B-A-B-Y
Jilted John - Jilted John
Fern Kinney - Together We Are Beautiful
Regents - 7 Teen
Brian and Michael - Matchstalk Men and Matchstalk Cats and Dogs
Driver 67 - Car 67
Goombay Dance Band - Seven Tears
St Winifred's School Choir - There's No-One Quite Like Grandma
Billy Ray Cyrus - Achy Breaky Heart
4 Non Blondes - What's Up?
OMC - How Bizarre
Afroman - Because I Got High
Jermaine Stewart - We Don't Have To Take Our Clothes Off
Reynolds Girls - I'd Rather Jack
Aqua - Barbie Girl
Timbuk 3 - The Future's So Bright, I Gotta Wear Shades
Mary Jane Girls - In My House
Angry Anderson - Suddenly
Edie Brickell - What I Am
Partners in Kryme - Turtle Power
Judie Tzuke - Stay With Me Til Dawn
David Zowie - House Every Weekend
Norman Greenbaum - Spirit in the Sky
The Crazy World of Arthur Brown - Fire
C.W. McCall - Convoy
Johnny Wakelin - Black Superman (Muhammed Ali)
Carl Douglas - Kung Fu Fighting
Nicky Thomas - Love Of The Common People
Jeannie C. Riley - Harper Valley PTA
The Overlanders - Michelle
Sue Nicholls - Where Will You Be
The Archies - Sugar Sugar
The Pipkins - Gimme Dat Ding
Hot Shots - Snoopy Vs The Red Baron
Ace - How Long
Rimshots - 7-6-5-4-3-2-1
Stretch - Why Did You Do It
Mark Wynter - It's Almost Tomorrow
Sorrows - Take A Heart
B. Bumble and the Stingers - Nut Rocker
Clive Dunn - Grandad
Titanium - David Guetta feat. Sia
Feel the Love - Rudimental feat. John Newman
Hey Brother - Avicii
How Deep Is Your Love - Calvin Harris & Disciples
Stay with Me - Sam Smith
Budapest - George Ezra
Stitches - Shawn Mendes
Waves - Mr. Probz
Cheerleader - OMI
Shut Up and Dance - WALK THE MOON
Cake By the Ocean - DNCE
King - Years & Years
Lean On - Major Lazer x DJ Snake feat. MØ
CAN'T STOP THE FEELING! - Justin Timberlake
Hold My Hand - Jess Glynne
Hall of Fame - The Script feat. will.i.am
Dancing on My Own - Calum Scott
Just Give Me a Reason - P!nk feat. Nate Ruess
Beneath Your Beautiful - Labrinth feat. Emeli Sandé
Ghost - Ella Henderson
Burn - Ellie Goulding
Just Dance - Lady Gaga feat. Colby O'Donis
I'm Yours - Jason Mraz
Riptide - Vance Joy
Lush Life - Zara Larsson
Work from Home - Fifth Harmony feat. Ty Dolla $ign
Dilemma - Nelly feat. Kelly Rowland
All About That Bass - Meghan Trainor
Black Magic - Little Mix
Timber - Pitbull feat. Ke$ha / Pitbull
The Hills - The Weeknd
Are You With Me - Lost Frequencies
Love Me Again - John Newman
Rude - MAGIC!
Let It Go - James Bay
How to Save a Life - The Fray
House of Fun - Madness
Planet Earth - Duran Duran
Just Like Heaven - The Cure
Together In Electric Dreams - The Human League
To Cut A Long Story Short - Spandau Ballet
Tainted Love - Soft Cell
You Spin Me Round (Like A Record) - Dead Or Alive
Imagination - Belouis Some
Like To Get To Know You Well - Howard Jones
The Harder I Try - Brother Beyond
Do You Really Want To Hurt Me - Culture Club
Everybody Wants to Rule the World - Tears for Fears
Walk Out To Winter - Aztec Camera
Each Time You Break My Heart - Nick Kamen
Dangerous - Roxette
Some Like It Hot - The Power Station
Life's What You Make It - Talk Talk
Army Dreamers - Kate Bush
Love Changes (Everything) - Climie Fisher
Town Called Malice - The Jam
The Cutter - Echo And The Bunnymen
Atomic - Blondie
I've Been Losing You - A-Ha
Ceremony - New Order
Isolation - Joy Division
Golden Brown - The Stranglers
Cry Boy Cry - Blue Zoo
Veronica - Elvis Costello
Paralysed - Gang Of Four
The Edge of Forever - The Dream Academy
Cry Little Sister (Theme from ''Lost Boys'') - Gerard McMann
Cccan't You See - Vicious Pink
The Politics Of Dancing - Re-Flex
Can't Be Sure - The Sundays
Election Day - Arcadia
Gentle Tuesday - Primal Scream
Stand And Deliver - Adam & The Ants
Blister In The Sun - Violent Femmes
There There My Dear - Dexy's Midnight Runners
Lucretia My Reflection - The Sisters Of Mercy
Love Missile F1-11 - Sigue Sigue Sputnik
51st State - New Model Army
Mountain Song - Jane's Addiction
Broken Land - The Adventures
Roam - The B-52's
I Can't Escape Myself - The Sound
Hyperactive! - Thomas Dolby
Don't Want To Know If You Are Lonely - Husker Du
Bastards Of Young - The Replacements
One Step - Kissing The Pink
Last Night Another Soldier - Angelic Upstarts
Oi! Oi! Oi! - Cockney Rejects
Over And Done With - The Proclaimers
Talk Of The Town - Pretenders
Florence & The Machine - Spectrum (Say My Name)
Roll Deep - Good Times (feat Jodie Connor)
The Black Eyed Peas - I Gotta A Feeling
Pixie Lott - Boys & Girls
Duffy - Mercy
The Pussycat Dolls - Don't Cha
Scissor Sisters - I Don't Feel Like Dancin'
Robyn - With Every Heartbeat
Cheryl Cole - Fight For This Love
John Newman - Love Me Again
Avicci - Wake Me Up
Psy - Gangnam Style
S Club 7 - Don't Stop Movin'
Sugababes - Freak Like Me
Girls Aloud - Sound Of The Underground
Yazz & The Public Population - The Only Way Is Up
Donna Summer - I Feel Love
Adamski - Killer (feat Seal)
Frankie Goes To Hollywood - Relax
Take That - Greatest Day
Gotye - Somebody That I Used To Know (feat Kimbra)
Owl City - Fireflies
Mika - Grace Kelly
McFly - All About You
Busted - Crashed The Wedding
Kaiser Chiefs - Ruby
Orson - No Tomorrow
Ronan Keating - Life Is A Rollercoaster
Razorlight - America
Pixie Lott - Mama Do (Uh Oh, Uh Oh)
S Club 7 - Bring It All Back
Sugababes - Push The Button
Darius - Colourblind
Sugababes - Hole In The Head
Busted - You Said No
McFly - Obviously
Daniel Bedingfield - If You're Not The One
David Sneddon - Stop Living The Lie
Ronan Keating - If Tomorrow Never Comes
S Club 7 - Never Had A Dream Come True
UB40 - Red Red Wine
Blondie - The Tide Is High
Ken Boothe - Everything I Own
Culture Club - Do You Really Wanna Hurt Me
The Spencer Davis Group - Somebody Help Me
Desmond Dekker & The Aces - Israelites
Dave Baker & Ansel Collins - Double Barrel
Chaka Demus & Pilers - Twist & Shout
Beats International - Dub Be Good To Me
Musical Youth - Pass The Dutchie
10cc - Dreadlock Holiday
Blondie - Heart Of Glass
Vic Reeves - Dizzy (feat The Wonder Stuff)
Madness - House Of Fun
The Jam - Going Underground
Kevin Rowland & Dexys Midnight Runners - Come On Eileen
The Boomtown Rats - Rat Trap
Buggles - Video Killed The Radio Star
The Flying Pickets - Only You
Dr Hook - When You're In Love With A Beautiful Woman
Smokey Robinson - Being With You
Michael Jackson - One Day In Your Life
Diana Ross - I'm Still Waiting
Girls Aloud - I'll Stand By You
Jim Diamond - I Should Have Known Better
Wet Wet Wet - Goodnight Girl
Ronan Keating - When You Say Nothing At All
Charlene - I've Never Been To Me
Chris De Burgh - Lady In Red
T'Pau - China In Your Hand
Take That - Patience
The Housemartins - Caravan Of Love
The Beautiful South - A Little Time
UB40 - (I Can't Help) Falling In Love With You
Boyzone - No Matter What
The Boomtown Rats - I Don't Lilke Mondays
Soft Cell - Tainted Love
The Human League - Don't You Want Me
Culture Club - Karma Chameleon
Feargal Sharkey - Good Heart
UB40 - I Got You Babe (feat Chrissie Hynde)
Boy George - Everything I Own
Soul II Soul - Back To Life (However Do You Want Me) (feat Caron Wheeler)
The Spencer Davis Group - Keep On Running
The Jam - Town Called Malice
Status Quo - Down Down
McFly - Five Colours In Her Hair
Blondie - Call Me
The Jam - Start!
Wet Wet Wet - Love Is All Around
Aswad - Don't Turn Around
Robin Beck - First Time
Roxy Music - Jealous Guy
Band Aid 30 - Do They Know It's Christmas?
Back to You - Louis Tomlinson feat. Bebe Rexha & Digital Farm Animals
Boys - Charli XCX
Your Song - RITA ORA
Power - Little Mix feat. Stormzy
Unpredictable - Olly Murs and Louisa Johnson
The Greatest - Sia
Be the One - Dua Lipa
Ciao Adios - Anne-Marie
Crying in the Club - Camila Cabello
Learn To Let Go - Kesha
Sax - Fleur East
Play That Song - Train
Still Got Time - ZAYN feat. PARTYNEXTDOOR
Up In Here - 5 After Midnight
Would You Mind - PRETTYMUCH
cant stop the feeling
No Promises - Cheat Codes feat. Demi Lovato
Came Here for Love - Sigala & Ella Eyre
Ain't Giving Up - Craig David & Sigala
Scared to Be Lonely - Martin Garrix & Dua Lipa
First Time - Kygo & Ellie Goulding
Just Hold On - Steve Aoki & Louis Tomlinson
Paris - The Chainsmokers
Best Behaviour - Louisa Johnson
You Don't Know Love - Olly Murs
Millionaire - Digital Farm Animals & Cash Cash feat. Nelly
No Money - Galantis
Easy Love - Sigala
Sunshine - TIEKS feat. Dan Harkna
On My Mind - Disciples
You Want Me - Tom Zanetti feat. Sadie Ama / Sadie Ama
More Than Friends - James Hype feat. Kelli-Leigh
Robin Thicke Feat. Pharrell - Blurred Lines
Jessie J - Domino
OneRepublic - Counting Stars
Avicii - Levels
Jennifer Lopez - On The Floor
Nicole Scherzinger - Right There
Ellie Goulding - Starry Eyed
Swedish House Mafia & Knife Party - Antidote
Christina Milian - AM to PM
Noisettes - Don't Upset The Rhythm (Go Baby Go)
Rizzle Kicks - Mama Do The Hump
Marcus Collins - Seven Nation Army
Girls Aloud - Something New
The Black Eyed Peas - The Time (Dirty Bit)
Jedward - Bad Behaviour
Pixie Lott - Kiss The Stars
Tinchy Stryder Feat. N-Dubz - Number 1
Selena Gomez - Come & Get It
Ne-Yo - Closer
Tinchy Stryder Feat. Pixie Lott - Bright Lights
D'Banji - Oliver Twist
Stooshe Feat. Travie McCoy - Love Me Again
Matt Willis - Crash
Ashlee Simpson - Pieces Of Me
D'Influence - Rock With You
Des'ree - You Gotta Be
Stock, Aitken & Waterman - Roadblock
Dawn Penn - You Don't Love Me (No, No, No)
Ultra Nate - Free
Snap! - Rhythm Is A Dancer
Rick Astley - Never Gonna Give You Up
Sybil - When I'm Good And Ready
Babybird - You're Gorgeous
The Farm - Groovy Train
Sugarhill Gang - Rapper's Delight
Shalamar - Take That To The Bank
Princess - Say I'm Your Number One
The Real Thing - You To Me Are Everything
Belle Stars - Sign Of The Times
Madness - It Must Be Love
James Brown - I Got You (I Feel Good)
Nelly - Hot In Herre
Montell Jordan - This Is How We Do It
KC & The Sunshine Band - That's The Way (I Like It)
Bachman - Turner Overdrive - You Ain't Seen Nothing Yet
Robert Palmer - Addicted To Love
Martha Reeves and The Vandellas - Dancing In The Street
Bryan Ferry - Let's Stick Together
Amii Stewart - Knock On Wood
Soulsearcher - Can't Get Enough
Shades Of Rhythm - The Sound Of Eden
Chris Montez - Let's Dance
Status Quo - Rockin' All Over
Jona Lewie - You'll Always Find Me In The Kitchen At Parties
Gwen Guthrie - Ain't Nothin' Goin' On But The Rent
Incognito - Always There
CJ Lewis - Sweets For My Sweet
Girls Aloud - The Promise
Kool And The Gang - Celebration
Barry White - You're The First, My Last, My Everything
Bodyrockers - I Like The Way
Bel Biv DeVoe - Poison
Ollie & Jerry - Breakin...There's No Stoppin' Us
Tears For Fears - Shout
Diana Ross - I'm Coming Out
Katrina And The Waves - Walking On Sunshine
The Chordettes - Lollipop
Madness - One Step Beyond
Marmalade - Ob-Bla-Di Ob-La-Da
ABC - Poison Arrow
The Spencer Davis Group - Gimme Some Lovin'
John Travolta - Greased Lightning
The Belle Stars - Sign Of The Times
Dandy Livingstone - Rudy, A Message To You
Kings Of Tomorrow - Finally
Pixie Lott - Boys And Girls
Mungo Jerry - In The Summertime
The Commitments - Mustang Sally
The Mavericks - Dance The Night Away
Kirsty MacColl - A New England
Jive Bunny - Swing The Mood
Danza Latina - Oye Como Va
Chaka Demus & Pliers - Tease Me
M.C. Hammer - U Can't Touch This
ATFC - In & Out Of My Life
Soul Central - Strings Of Life (Stronger On My Own)
Harry J All Stars - Liquidator
Sam Sparro - Black And Gold
The Contours - Do You Love Me
Yazz & The Plastic Population - The Only Way Is Up
Kylie Minogue - Give Me Just A Little More Time
808 State - Pacific 707
Snap! - The Power
Stock Aitkin & Waterman - Roadblock
The Beat - Mirror In The Bathroom
Fat Les - Vindaloo
Alicia Bridges - I Love The Nightlife
M - Pop Musik
Lulu And The Luvvers - Shout
Liberty X - Just A Little
Harold Faltermeyer - Axel F
Bob Marley Versus Funkstar Deluxe - Sun Is Shining
Frankie Goes To Hollywood - Two Tribes
Madness - Baggy Trousers
The Goombay Dance Band - Seven Tears
Tracey Ullman - Breakaway
Gilbert O'Sullivan - Get Down
Foundations - Build Me Up Buttercup
Sandie Shaw - Puppet On A String
Dexy's Midnight Runners - Come On Eileen
Shalamar - A Night To Remember
Tenpole Tudor - Swords Of A thousand Men
Arrow - Hot Hot Hot
Jive Bunny - That's What I Like
Elvis Presley - Love Me Tender
Paul Anka - Diana
Buddy Holly - It Doesn't Matter Anymore
Brian Hyland - Sealed With A Kiss
Bobby Darin - Things
Bobby Rydell - Forget Him
Dave Berry - The Crying Game
Mark Wynter - Go Away Little Girl
Dusty Springfield - Son Of A Preacher Man
Small Faces - All Or Nothing
Cilla Black - Anyone Who Had A Heart
Sandie Shaw - (There's) Always Something There To Remind Me
Ricky Valance - Tell Laura I Love Her
The Four Pennies - Juliet
Patsy Cline - Crazy
Emile Ford and The Checkmates - What Do You To Make Those Eyes At Me For
Conway Twitty - It's Only Make Believe
Danny Williams - Moon River
Tom Jones - Green Green Grass Of Home
The Fortunes - You've Got Your Troubles
The Mindbenders - Groovy Kind Of Love
The Mersybeats - I Think Of You
The Moody Blues - Nights In White Satin
Scott Walker - Joanna
Scott Bruton and Daisy Wood - Davis
The Beach Boys - Do It Again
Frankie Valli & The Four Seasons - Rag Doll
Cliff Richard and The Shadows - Bachelor Boy
The Kinks - Tired Of Waiting For You
Eden Kane - Forget Me Not
John Leyton - Wild Wind
Neil Sedaka - Happy Birthday Sweet Sixteen
The Hollies - Look Through Any Window
Lou Christie - Lightning strikes
Helen Shapiro - Don't Treat Me Like A Child
Kathy Kirby - Secret Love
The Springfields - Say I Won't Be There
Petula Clarke - Downtown
Craig Douglas - Only Sixteen
The Chiffons - One Fine Day
The Searchers - Needles and Pins
Gerry and The Pacemakers - I Like It
Cat Stevens - The First Cut Is The Deepest
Herman Hermits - No Milk Today
The Yardbirds - For Your Love
Jonny Burnette - Dreamin'
Lesley Gore - It's My Party
Bruce Channel - Hey! Baby
Little Eva - The Locomotion
Millie - My Boy Lollipop
The Tremeloes - Here Comes My Baby
Ritchie Valens - La Bamba
Arthur Conley - Sweet Soul Music
Stevie Wonder - Uptight (Everything's Alright)
Chubby Checker - Dancin' Party
Buddy Knox - Party Doll
Lulu - Shout
Bern Elliott and The Fenmen - Money
The Troggs - With A Girl Like You
Billie Davis - Tell Him
Dean Martin - Sway (Quien Sera)
Trini Lopez - If I Had A Hammer
Chuck Berry - Roll Over Beethoven
Little Richard - Long Tall Sally
Eddie Cochran - Three Steps To Heaven
Lonnie Donegan & His Skiffle Group - The Battle Of New Orleans
The Everly Brothers - Wake Up Little Susie
Gene Vincent & His Blue Caps - Blue Jean Bop
Bill Haley & His Comets - (We're Gonna) Rock Around The Clock
Bobby Vee - Rubber Ball
Marty Wilde - Bad Boy
Connie Francis - Lipstick On Your Collar
Brenda Lee - Here Comes That Feeling Again
The Shadows - F.B.I
The Ventures - Walk Don't Run
Duane Eddy & The Rebelettes - Dance With The Guitar Man
Jet Harris and Tony Meehan - Scarlett O'Hara
Link Wray & His Ray Men - Rumble
Del Shannon - Hats Off To Larry
Marvin Rainwater - Whole Lotta Woman
Fats Domino - Blueberry Hill
The Nashville Teens - Tobacco Road
The Herd - I Don't Want Our Loving To Die
Gary U.S. Bonds - Quarter To Three
Bye Bye Bye - *NSYNC
All Rise - Blue
Keep On Movin' - Five
SexyBack - Justin Timberlake feat. Timbaland
Beat Again - JLS
Glad You Came - The Wanted
Carry You - Union J
World of Our Own - Westlife
Same Old Brand New You - A1
Bodyshakin' - 911
I've Got a Little Something for You - MN8
Liquid Dreams - O-Town
Ghetto Romance - Damage feat. Siamese
Give It to You - Jordan Knight
Be Alone No More - Another Level
Crossroads - Blazin' Squad
Picture of You - Boyzone
Flying Without Wings - Westlife
Everything Changes - Take That
It's Alright - East 17
If Ya Gettin' Down - Five / Indeep
You Got It (The Right Stuff) - New Kids On The Block
Everything She Wants - Wham!
When Will I Be Famous? - Bros
Let's Get Ready to Rhumble - PJ & Duncan
Mysterious Girl - Peter Andre
Casanova - Ultimate Kaos
Tearin' up My Heart - *NSYNC
All or Nothing - O-Town
Freak Me - Another Level
Everybody in Love - JLS
Love II Love - Damage
I Do (Cherish You) - 98°
Anything - 3T
Better the Devil You Know - Kylie Minogue
Never Gonna Give You Up - Rick Astley
Venus - Bananarama
Respectable - Mel & Kim
One For Sorrow - Steps
I Should Be So Lucky - Kylie Minogue
Too Many Broken Hearts - Jason Donovan
Roadblock - Stock Aitken Waterman
You'll Never Stop Me Loving You - Sonia
Nothing's Gonna Stop Me Now - Samantha Fox
I'd Rather Jack - The Reynolds Girls
Heartache - Pepsi And Shirlie
Whenever You Need Somebody - Rick Astley
When I'm Good and Ready - Sybil
Every Day (I Love You More) - Jason Donovan
Nathan Jones - Bananarama
Especially For You - Kylie Minogue & Jason Donovan
Tragedy - Steps
Showing Out (Get Fresh At The Weekend) - Mel & Kim
The Loco-Motion - Kylie Minogue
Together Forever - Rick Astley
Nothing Can Divide Us - Jason Donovan
The Grease Mega-Mix - John Travolta & Olivia Newton John
Love in the First Degree - Bananarama
Heartbeat - Steps
Hand On Your Heart - Kylie Minogue
Say I'm Your Number One - Princess
Toy Boy - Sinitta
I Only Wanna Be With You - Samantha Fox
I Just Don't Have The Heart - Cliff Richard
Pass The Dutchie - Musical Youth
I Heard a Rumour - Bananarama
If You Were With Me Now - Kylie Minogue & Keith Washington
Seasons In The Sun - Westlife
Sealed with a Kiss - Jason Donovan
When I Fall in Love - Rick Astley
