Joe Walsh - Life's Been Good
Steve Harley & Cockney Rebel - Make Me Smile
Warren Zevon - Werewolves Of London
Rickie Lee Jones - Chuck E's In Love
Seals & Crofts - Summer Breeze
BA Robertson - Bang Bang
Foreigner - Hot Blooded
The Cars - Just What I Needed
Dave Edmunds - I Hear You Knocking
Brownsville Station - Smokin' In The Boys Room
Flamin' Groovies - Shake Some Action
The Stooges - Loose
The Stranglers - (Get A) Grip On Yourself
Madness - The Prince
The Trammps - Didco Inferno
Chic - Everybody Dance
Hot Chocolate - Every 1's A Winner
KC & The Sunshine Band - Queen Of Clubs
Gino Soccio - Dancer
The Four Seasons - December 63'
Aretha Franklin - Spanish Harlem
Fun Boy Three - Our Lips Are Sealed
Blancmange - Living On The Ceiling
Living In A Box - Blow The House Down
Howard Jones - Things Can Only Get Better
Christopher Cross - All Right
Mel & Kim - Repectable
Happy Mondays - Hallelujah
Adeva - Respect
Hollywood Beyond - What's The Colour Of Money
Brother Beyond - The Harder I Try
Jaki Graham - Round & Around
Chris Rea - Let's Dance
Pretenders - Back On The Chain Gang
Kim Wilde - Chequered Love
David Lindley - Twist & Shout
Paul Carrack - When You Walk In The Room
The Colourfield - Thinking Of You
House of Fun Madness
Gangsters The Specials
Humph on the Case Death in Paradise Cast & Magnus Fiennes
54-46 Was My Number Toots & The Maytals
Return of the Django The Upsetters
Money in My Pocket Dennis Brown
Buzzcocks - Ever Fallen In Love
Ramones - Shenna Is A Punk Rocker
The Stooges - I Wanna Be Your Dog
The Stranglers - No More Heroes
Richard Hell & The Voidoids - Blank Generation
The Vapors - Turning Japanese
Generation X - Dancing With Myself
Ultravox - Sleepwalk
Kim Wilde - Kids In America
Funboy Three - The Lunatics Have Taken Over The Asylum
Gang Of Four - I Love A Man In Uniform
Thomas Dolby - She Blinded Me With Science
Vicious Pink - Ccant You See
The Seelecter - Three Minute Hero
The Beat - The Tears Of A Clown
L7 - Pretend We're Dead
Buzzcocks - Promises
Angelic Upstarts - Last Night Another Soldier
999 - Homicide
X - Johnny Hit & Pauline Run
Gabrielle Aplin - Please Don't Say You Love Me
Foreigner - Waiting For A Girl Like You
All Saints - Pure Shores
Plan B - Prayin'
Lily Allen - The Fear
Kylie Minogue - All The Lovers
Stooshe - Black Heart
Mystery Jets - Half In Love With Elizabeth
Two Door Cinema Club - Changing Of The Seasons
Lianne La Havas - Forget
Boyzone - Love Will Save The Day
Mick Hucknall - Turn Back The Hands Of Time
Wankelmut & Emma Louise - My Head Is A Jungle
Disclosure Feat. AlunaGeorge - White Noise
Shift K3Y - I Know
Redlight - 9TS 90s Baby
Storm Queen - Look Right Through
Fish Go Deep Feat. Tracey K - The Cure & The Cause
Tina Moore - Never Gonna Let U Go
Swedish House Mafia Feat. Pharrell - One
Wilkinson Feat. Talay Riley - Dirty Love
Chase & Status Feat. Moko - Count On Me
Lana Del Rey - Summertime Sadness
Tove Lo - Habits (Stay High)
Lilly Wood & The Prick & Robin Schulz - Prayer In C
Mr. Probz - Waves
Secondcity Feat. Ali Love - What Can I Do
Para One - You Too
LuvBug Feat. Talay Riley - Resonance
Milky Chance - Stolen Dance
Linda Lewis - "Baby I'm Yours"
MFSB - "TSOP (The Sound Of Philadelphia)" (feat The Third Degrees)
The Jacksons - "Shake Your Body (Down To The Ground)"
Billy Ocean - "Red Light Spells Danger"
Mtume - "Juicy Fruits"
Haywoode - "Roses"
Aretha Franklin - "Who's Zoomin Who"
Pointer Sisters - "Automatic"
TLC - "Waterfalls"
Chequered Love - Kim Wilde
Gimme All Your Lovin' - Zz Top
Forget Me Nots - Patrice Rushen
The Tunnel Of Love - Fun Boy Three
Pray For Love - Kwabs
Littlest Things - Lily Allen
I Loved You (Feat. Melissa Steel) - Blonde
Freak In You (Mk Dub) - Jodeci
Straight To Your Heart - Grum
The Key (Feat. Kelis) - Breach
Freedom - Grades
The Label - Friend Within
So Good To Me - Chris Malinchak
Yah Mo B There - James Ingram Feat. Michael McDonald
Keep On Walkin' - CeCe Peniston
Remember The Time - Michael Jackson
Too Young To Die - Jamiroquai
Turn Me On - Kevin Lyttle
Calvin Harris - Summer
David Guetta, Sam Martin - Lovers On The Sun
Wilkinson, Talay Riley - Dirty Love
Kiesza - No Enemiesz (Album Version)
Route 94, Jess Glynne - My Love
Tiga - Bugatti
Redlight - 9TS (90s Baby)
Ariana Grande, Zedd - Break Free
Dimitri Vegas, Martin Garrix, Like Mike - Tremor
Got To Have Your Love - Featuring Wondress
Back To Life - Soul II Soul featuring Caron Wheeler
Yarbrough & Peoples - Don't Stop The Music
David Joseph - You Can't Hide Your Love (From Me)
Laura Branigan - Self Control
Shakatak - Down On The Street
DeBarge - Rhythm Of The Night
Shattered Dreams - Johnny Hates Jazz
Obsession - Animotion
Addicted To Love - Robert Palmer
Breakin'... There's No Stoppin' Us - Ollie & Jerry
There It Is - Shalamar
Breakout - Swing Out Sister
Lessons In Love - Level 42
A Good Heart - Feargal Sharkey
Do It To The Music - Raw Silk
The Sign Of The Times - The Belle Stars
Heartache Avenue - The Maisonettes
Cher - Gypsies, Tramps And Thieves
Amii Stewart - Knock On Wood
5000 Volts - I'm On Fire
Boney M - Sunny
Melba Moore - This Is It
Silver Convention - Get Up And Boogie
Cheryl Lynn - Got To Be Real
Candi Staton - Nights On Broadway
Rufus ft Chaka Khan - Tell Me Something Good
Stephanie De Sykes - Born With A Smile On My Face
The Fifth Dimension - Wedding Day Blues
Baccara - Sorry I'm A Lady
Tina Charles - Dr. Love
Fox - S-S-S-Single Bed
Walker Brothers - The Sun Ain't Gonna Shine Anymore
The Dixie Cups - Chapel Of Love
Lesley Gore - Maybe I Know
The Herd - From The Underworld
I Feel It All - Feist
Secrets - OneRepublic
Don't Tell Me That It's Over - Amy MacDonald
Ooh La - The Kooks
Toothpaste Kisses - The Maccabees
One Love, One Life, One Girl - The Wildhearts
Secret Smile - Semisonic
Blowing Kisses - Sarabeth Tucek
Lose Myself In You - The Mission
Wild Thing - The Troggs
Lindisfarne - Lady Eleanor
Helen Reddy - I Am Woman
Just Give Me a Reason - P!nk feat. Nate Ruess
Missing You - John Waite
Counting Stars - OneRepublic
Complicated - Avril Lavigne
Since You Been Gone - Rainbow
Poison - Alice Cooper
Keep On Loving You - REO Speedwagon
My Girl - Otis Redding
Knock On Wood - Eddie Floyd
Shanice - I Love Your Smile
98 Degrees ft Stevie Wonder - True To Your Heart
Edwin Starr ft Blinky - I'm Glad You Belong To Me
Stevie Wonder - Yester-Me, Yester-You, Yesterday
Frankie Valli & The Four Seasons - The Night
Edwin Starr - War
Jermaine Jackson - Let's Get Serious
Rick James - Super Freak
I Knew You Were Waiting - George Michael & Aretha Franklin
Brown Eyed Girl - Van Morrison
Dream Catch Me - Newton Faulkner
Wildfire - John Mayer
When a Fire Starts to Burn - Disclosure
Special (Feat. Maxine Ashley) - Billon
Don't Stop - Sirus Hood
Forget - Patrick Topping
Push the Feeling On 2014 - Nightcrawlers vs DJ S.K.T
I Think I'm in Love with You- Jessica Simpson
My Life Would Suck Without You- Kelly Clarkson
You & Me Song- The Wannadies
Here You Come Again ((Single) [Remaster]) Dolly Parton
Shining Light- Annie Lennox
Lovely One- The Jacksons
Got to Get You into My Life- Earth Wind & Fire
How Glad I Am (Remastered) Aretha Franklin
Leviticus - Burial
DJ Marky & XRS Feat. Stamina MC - LK (Original)
Ram Trilogy - Screamer
Un - Cut
Shimon & Andy C - Body Rock
Wilkinson - Afterglow
Sub Focus Feat. Alpines - Tidal Wave
Andy C & Fiora - Heartbeat Loud
Danny Byrd Feat. I - Kay
DJ Fresh Feat. Ms Dynamite - Gold Dust
Kokiri - Retrospect
Fritz Kalkbrenner - Back Home
Bob Moses - Grace
Reflections Of My Life - Marmalade
Young At Heart - The Bluebells
Magic - Pilot
I Don t Want To Go Out - Nerina Pallot
Just Like Sherlock Holmes - Ray Manzarek & Roy Rogers
Numbers - Ray Manzarek & Roy Rogers
Liquid Highway - Cliff Morrison (Feat. Jim Morrison) & The Lizard Sun Band
The Crystal Ship - Edgar Winter & Chris Spedding
Break On Through (To The Other Side) - Mark Farner & Chick Churchill
Hello, I Love You - Ken Hensley
Love Her Madly - Mick Box & Mark Stein
Alabama Song - Todd Rundgren & Geoff Downes
Love Me Two Times - Lou Gramm, Thijs Van Leer & Larry Coryell
Gloria - The Shadows Of Knight
Alabama Song - Lotte Lenya
Blame (Feat. John Newman) - Calvin Harris
West Coast - Lana Del Rey
Red Eyes - The War On Drugs
Lovers On The Sun (Feat. Sam Martin) - David Guetta
Air Balloon - Lily Allen
In The Heat Of The Moment - Noel Gallagher's High Flying Birds
Time - Jungle
Eez-Eh - Kasabian
Figure It Out - Royal Blood
Another One Bites The Dust (1994 Remastered Version) - Queen
Rock Your Body - Justin Timberlake
I Kissed A Girl - Katy Perry
Seven Nation Army - The White Stripes
Let's Get Ready To Rhumble - Pj & Duncan
Last All Night (Koala) [Feat. Kstewart] - Oliver Heldens
Sing That Song (Feat. Celeste) - Tieks
Dangerous (Feat. Sam Martin) - David Guetta
Begin Again - Knife Party
Runaway (U & I) - Galantis
Round & Round - Sugababes
When I Grow Up - The Pussycat Dolls
More, More, More - Rachel Stevens
The Best of Both Worlds - High School Hits
Sweet About Me - Gabriella Cilmi
Pure & Simple - Hear'Say
Uptown Girl - Westlife
MMM Bop - Hanson
Mambo No 5 - Danza Latina
Twist & Shout - Chaka Demus & Pliers
Track  9
Track 11
Daydream in Blue - I Monster
Agua De Beber - Xavier Osmir
The One That Got Away - Katy Perry
B*Witched - C'est La Vie
New Kids On The Block - Step By Step
Five - Everybody Get Up
Pras - Blue Angels
TLC - No Scrubs
MN8 - I've Got A Little Something For You
Reef - Place Your Hands
C&C Music Factory ft Freedom Williams - Gonna Make You Sweat (Everybody Dance
Retrospect - Kokiri
Not Into It - Shift K3Y
Can't Stop Playing (Makes Me High) (Feat. Ane Brun)  - Dr. Kucho! & Gregor Salto
Sante & Sidney Charles - "All Night Long"
Bambook & Mennie - "Slip Away" (feat Cari Golden)
Changing - Sigma feat. Paloma Faith
Rude - MAGIC!
Am I Wrong - Nico & Vinz
Candy - Robbie Williams
Rather Be - Clean Bandit feat. Jess Glynne
Love Me Again - John Newman
Feel the Love - Rudimental feat. John Newman
Raise Your Glass - P!nk
Busy Earnin - Jungle
Let It Be - Labrinth
Calling All Hearts - DJ Cassidy feat. Robin Thicke & Jessie J
Ugly Heart - G.R.L.
Die Young - Ke$ha
Push The Button - Sugababes
In For The Kill - La Roux
Sweet Dreams My L.A. Ex - Rachel Stevens
Up - The Saturdays
Don't Cha - The Pussycat Dolls
Running In The Family - Level 42
I Only Want To Be With You - Dusty Springfield
She's A Lady - Tom Jones
DJ Eibhlin - Bring Me Joy
Lazy River- Bobby Darin
Calender Gir-l Neil Sedaka
These boots are made for walking - Simpson Jessica
Crazy Chick - Church Charlotte
1 thing - Amerie (
Girls On Top - Girl Thing
I'm in the mood for dancing - Nolans The
Band Of Gold - Payne Freda
No More Tears (Enough Is Enough) - Mazelle Kym / Brown Jocelyn
Rhythm Is Gonna Get You - Estefan Gloria
Bad Girl - DJ Rap
Girl in a Country Song - Maddie & Tae
Scissor Sisters - I Don't Feel Like Dancin'
Billy Joel - Tell Her About It
Olly Murs ft Travie McCoy - Wrapped Up
Ben Haenow - Something I Need
Rumer - Dangerous
Lana Del Rey - West Coast
Banks - Drowning
Nick Mulvey - Cucurucu
Clean Bandit - Rather Be (feat Jess Glynne)
Disclosure - Help Me Lose My Mind (feat London Grammar)
Jess Glyne - Right Here
Faul & Was Ad vs Pnau - Changes
Klangkarussell - Sonnentanz (Sun Don't Shine) (feat Will Heard -)
Empire Of The Sun - Walking On A Dream
Cherrelle - I Didn't Mean To Turn You On
Leo Sayer - Thunder In My Heart
Aswad - Shine
It's A Hard Knock Life (Annie) - Sarah French
Goldfinger (Goldfinger) - Shirley Bassey
Days (Sunny Afternoon) - Kirsty MacColl
Hallelujah (Shrek) - Rufus Wainwright
Road Runner - Bo Diddley
Sea Cruise - Frankie Ford
Move It On Over - Hank Williams
Put Your Cat Clothes On - Carl Perkins
The Girl Can't Help It - Little Richard
Rockin' Rollin' Stone - Andy Starr
Rocky Road To Dublin (Paddy Kelly)
Billy Idol - Rebel Yell
Thin Lizzy - Boys Are Back In Town
Nazareth - My White Bicycle
Nazareth - Hair of the Dog
Gillan - New Orleans
Norman Greenbaum - Spirit In the Sky
Cher - I Found Someone
Sandie Shaw - Route 66
Canned Heat - On the Road Again
Rare Earth - I Just Want To Celebrate
Catatonia - Road Rage
Gossip - Standing In the Way of Control
Dodgy - Good Enough
Dionne Warwick- Walk On By
Peggy Lee- Fever
Tennessee Ernie Ford- Sixteen Tons
The Beach Boys - God Only Knows
Doris Day - Move Over Darling
Adam and the Ants - Stand and Deliver
Bangles - Walk Like an Egyptian
Altered Images - I Could Be Happy
Dead or Alive - That's the Way (I Like It)
Martika - I Feel the Earth Move
Cyndi Lauper - Time After Time
Rick Astley - Whenever You Need Somebody
Landscape - Norman Bates
Why Won't You Give Me Your Love? - The Zutons
Country Girl - Primal Scream
Silver - Hundred Resons
Aisha - Death In Vegas (
The Ballad Of Tom - Space With Cerys Of Catanonia
Trash - Suede
Release The Pressure (Clean Version) - Leftfield
If I Can't Change Your Mind - Sugar
Indian Love Call - Slim Whitman
Don't Let The Stars Get In Your Eyes - Skeets McDonald
Ed Sheeran - Sing
Fergie - L.A.LOVE (la la)
5 Seconds of Summer - What I Like About You
Katy Perry - This Is How We Do
Lilly Wood & Robin Schulz - Prayer In C
Ella Henderson - Glow
No No No - Dawn Penn
Rome Wasn't Built In A Day - Morcheeba
Everything Everything - 'Cough Cough' (BBC Maida Vale Session)
Sigma feat. Labrinth - Higher
Gorgon City feat. Jennifer Hudson - Go All Night
Embracing The Sunshine - BT
Rita Ora - I Will Never Let You Down
Meghan Trainor - All About The Bass
Emeli Sande - Next To Me
Girls Like Us (Feat. Crissy D & Lady G) - The B15 Project
Horny '98 - Mousse T
Flawless - The Ones
Doctor Pressure (Miami Sound Machine Vs Mylo) - Mylo
Earth Wind Fire - Let's Groove
It's A Shame - The Detroit Spinners
Right Place Wrong Time
Rock Me Again & Again & Again & Again & Again & Again - Lyn Collins
Rosanna - Toto
The Touch - Stan Bush
Don't Talk to Strangers - Rick Springfield
The Mayans Are Coming Back - Future Disciple
Shake Your Rump To The Funk - The Bar-Kays
Don't Stop The Music - Yarbrough & Peoples
I Believe In Miracles - Jackson Sisters
Upside Down - Diana Ross
Everybody Loves The Sunshine - Roy Ayers Ubiquity
Movin' - Brass Construction
Dr Kucho! & Gregor Salto Feat. Ane Brun - Can't Stop Playing (Makes Me High)
The Magician Feat. Years & Years - Sunlight
Duke Dumont Feat. A*M*E - Need U (100%)
Ben Pearce - What I Might Do
Dansson & Marlon Hoffstadt - Shake That
Hot Natured - Benediction
Finnebassen - Touching Me
Tube & Berger - Come On Now (Set It Off) (feat Juliet Sikora)
Up - Olly Murs feat. Demi Lovato
Feel - Robbie Williams
Higher - Sigma
Freakin' Tight - Tough Love
The Nights - Avicii
Go All Night - Gorgon City feat. Jennifer Hudson
Loving Every Minute - Latroit
Anthem - Brookes Brothers feat Camille
I Got U - Duke Dumont
Fade Out Lines (Avener Rework) - The Avener
Tom Browne - Funkin For Jamaica
Michael Jackson - Don't Stop 'Til You Get Enough
The Fatback Band - (Are You Ready) Do The Bus Stop
The Meters - Cissy Strut
Love Runs Out - Willie Hutch
Like I Can - Sam Smith
Your Body - Christina Aguilera
These Days - Take That
Break Free - Ariana Grande feat. Zedd
Underdog - Kasabian
I See You Baby - Groove Armada feat. Gram'ma Funk
I Got You (I Feel Good) - James Brown
Sweet Dreams (Are Made of This) - Eurythmics
The Reflex - Duran Duran
Money - The Flying Lizards
Together in Electric Dreams - Philip Oakey / Giorgio Moroder
Too Shy - Kajagoogoo
Living on the Ceiling - Blancmange
Is It a Dream? - Classix Nouveaux
Whip It - Devo
Moments in Love - Art Of Noise
Unbroken - Kg
Until The World Ends - Black Sun Empire & State Of Mind Feat. Pnc
They Don't Know - Discipline
Together - 24 Hour Experience
To Be Real - Ladycop
Unbelievable - Emf
The Woodpile - Frightened Rabbit
Beep Beep - The Playmates
Monster Mash - Bobby 'Boris' Pickett & The Crypt Kickers
Ahab The Arab - Ray Stevens
Like I Love You - Justin Timberlake
Girlfriend - Avril Lavigne
Valerie - The Zutons
To Describe You (Feat. Molly) - Kungs & Mozambo
Need U (100%) - Duke Dumont
Heroes (Feat. Tove Lo) - Alesso
Can't Stop Playing (Makes Me High) (Feat. Ane Brun) - Dr. Kucho! & Gregor Salto
Take Over Control (Feat. Eva Simons) - Afrojack
Hot Right Now (Feat. Rita Ora) - DJ Fresh
More Than a Lover - Style of Eye
I Heard It Through The Grapevine - Gladys Knight & The Pips
Uptown Funk - Mark Ronson Feat. Bruno Mars
The Rhythm - MNEK
One - Swedish House Mafia ft. Pharrell
Toxic - Britney Spears
We R Who We R - Ke$h
Love Come Down - Evelyn "Champagne" King
All Cried Out - Alison Moyet
Can't Rely on You - Paloma Faith
Living After Midnight - Judas Priest
The Free Electric Band - Albert Hammond
Any Way You Want It - Journey
The Witch Queen Of New Orleans - Redbone
Mississippi Queen - Mountain
Tuff Enuff - The Fabulous Thunderbirds
Locked out of Heaven - Bruno Mars
Riptide - Vance Joy
Lollipop
The Mamas & The Papas - California Dreamin'
The Surfaris - Wipe Out
Mungo Jerry - In The Summertime
I Wanna Dance with Somebody (Who Loves Me) - Whitney Houston
We Didn't Start the Fire - Billy Joel
Touch Me (I Want Your Body) - Samantha Fox
Brother Louie - Modern Talking
Walk This Way - RUN-DMC feat. Aerosmith
We Built This City - Starship
Love & Pride - King
Dr. Beat - Miami Sound Machine
Love of the Common People - Paul Young
Summer - Calvin Harris
Turn It Up - Ciara feat. Usher
Till the World Ends - Britney Spears
TiK ToK - Ke$ha
Heart Skips a Beat - Olly Murs feat. Rizzle Kicks
Brokenhearted - Karmin
Million Dollar Bill - Whitney Houston
She's so Lovely - Scouting For Girls
These Boots Are Made for Walkin' - Jessica Simpson
Party All Night (Sleep All Day) - Sean Kingston
Unwritten - Natasha Bedingfield
Broken Heels - Alexandra Burke
Want U Back - Cher Lloyd
Toyboy & Robin - Jaded
Breach - Jack
We Are Your Friends - Justice Vs Simian
Booyah - Showtek Feat. We Are Loud! & Sonny Wilson
I Can See Clearly Now - Jimmy Cliff
LA Love - Fergie
Don't Cha - Pussycat Dolls
Round Round - Sugababes
The Voices - Eelke Klein
Can't Get Enough - Bad Company
Black Betty - Ram Jam
Everybody Get Up - Five / Joan Jett
Brass In Pocket - The Pretenders
Stumble (RSR Deep Wash) - Random Soul
Breaking the Law - Judas Priest
Summer Breeze - Seals & Crofts
The Rhythm Of The Night - Corona
Don't Give Me Your Life - Alex Party
The Real Thing - Tony Di Bart
Waiting All Night - Rudimental feat. Ella Eyre
Hey Brother - Avicii
Lady Marmalade - Labelle feat. Patti LaBelle
Chirpy Chirpy Cheep Cheep - Middle Of The Road
Girls, Girls, Girls - Sailor
House Every Weekend - David Zowie
I Loved You - Blonde, Melissa Steel
Say Something - Karen Harding
Treasured Soul - Michael Calfan
White Noise - Disclosure, AlunaGeorge
Yeah Yeah - Bodyrox, Luciana
Way We Are - Kove, Melissa Steel
Running - Jessie Ware
Bugatti - Tiga
Hey Hey - Dennis Ferrer
Shine- Aswad
Too Hot- FYA
Outside - Calvin Harris feat. Ellie Goulding
Stole the Show - Kygo feat. Parson James
Cheerleader - OMI
Outlines - Mike Mago & Dragonette
Changes - Faul & Wad Ad vs. Pnau
Prayer in C - Lilly Wood And The Prick and Robin Schulz
Rumors - Pep & Rash
Gravity - DJ Fresh feat. Ella Eyre
Rude - MAGIC! / Cloud One
Gotta Work - Amerie
Disclosure Feat. Sam Smith - Latch
Avicii - Wake Me Up
Duck Sauce - Barbara Streisand
Dr. Kucho! & Gregor Salto Feat. Ane Brun - Can't Stop Playing (Makes Me High)
Everybody's Somebody's Fool
Do You Love Me Like You Kiss Me
Drop It Joe
Don't Break The Heart That Loves You
It's Gonna Take Me Some Time
Valentino
Having A Party - Sam Cooke
Let's Stomp - Bobby Comstock
Keep Your Hands Off My Baby - Little Eva
Unchain My Heart - Ray Charles
Harlem Shuffle - Bob & Earl
Harper Valley P.T.A. - Jeannie C. Riley
(The Man Who Shot) Liberty Valance - Gene Pitney
Zip-A-Dee-Doo-Dah - Bob B. Soxx & The Blue Jeans
Alley Oop - Dante & The Evergreens
Watch Your Step - Bobby Parker
Run Baby Run - The Newbeats
Corinne Corinna - Ray Peterson
Walk Right In - The Rooftop Singers
Lies - The Knickerbockers
Hey Hey Baby - Otis Redding
Those Oldies But Goodies (Remind Me Of You) - Little Caesar & The Romans
It Will Stand - The Showmen
Let's Get Slow (Feat. Benjamin Diamond) - Aeroplane
The First - Ben Macklin
Get On Up - Opolopo
All I Want Is You (Feat. Keyhole) - Kraak & Smaak
Just Like You - Louis La Roche
Last All Night (Koala) - Oliver Heldens feat. KStewart
If U Got It - Chris Malinchak
My Love - Route 94 feat. Jess Glynne
Waves - Mr. Probz
Money on My Mind - Sam Smith
Jack - Breach
Take Me Away - DJ S.K.T feat. Rae
Eat Sleep Rave Repeat - Fatboy Slim & Riva Starr feat. Beardyman
Infinity - Guru Josh
Magic Carpet Ride 07' - Mighty Dub Katz
Don't You Want Me - Felix
Good Life - Inner City
Free - Ultra Naté
The Bomb! (These Sounds Fall Into My Mind) - Kenny Dope Presents The Bucketheads
Don't Call Me Baby - Madison Avenue
I Luv U Baby - The Original
My Generation - The Who
I'm a Man - The Spencer Davis Group
All Or Nothing - Small Faces
Beggin' - Timebox
She's About a Mover - Sir Douglas Quintet
I'm Gonna Be a Rich Man - The Foundations
Circles - Les Fleurs De Lys
The Entertainer - Tony Clarke
First I Look at the Purse - The Contours
Yeh Yeh - Georgie Fame & The Blue Flames
Hi-heel Sneakers - Tommy Tucker
Green Onions - Booker T. and the M.G.'s
The in Crowd - Dobie Gray
Smokestack Lightning - Howlin' Wolf
Night Train - James Brown
Last Night - The Mar-Keys
I'm Comin' Home - Mel Torme
Since You've Been Gone - Aretha Franklin
I Can't Turn You Loose - Otis Redding
You Can't Sit Down, Pt. 1 - Phil Upchurch
Love Loves to Love - Lulu
Teen Beat 65 - Sandy Nelson
Leaving Here - The Birds
Time for Action - Secret Affair
Poison Ivy - The Lambrettas
Dance Stance - Dexys Midnight Runners
Midnight to Six - Small Hours
Tears of a Clown - The Beat
Blazing Fire - Derrick Morgan
You Can Get It If You Really Want - Desmond Dekker
Don't You Just Know It - Huey 'Piano' Smith
Go Go Power - Sugar Pie Desanto
Shake It - Metro Station
Black & Gold - Sam Sparro
Starz In Their Eyes - Just Jack
Here (In Your Arms) - Hellogoodbye
Pumped Up Kicks - Foster The People
Golden Touch - Razorlight
Naive - The Kooks
Sweet Disposition - The Temper Trap
Chocolate - The 1975
Monster - The Automatic
We Are Young - Fun.
Radioactive - Imagine Dragons
This Ain't A Scene It's An Arms Race - Fall Out Boy
In The Shadows - The Rasmus
I Write Sins Not Tragedies - Panic! At The Disco
Buck Rogers - Feeder
Wonderful Life - Hurts
Ready for the Floor - Hot Chip
Sleepyhead - Passion Pit
Blackout - Breathe Carolina
Automatic - Don Broco
Money - Peace
The Great Escape - Boys Like Girls
If You Wanna - The Vaccines
Love Sublime (Feat. Nile Rodgers & Fiora) - Tensnake
Heaven Sent - Ferreck Dawn
Silverlined - XYconstant
Ein Tag Am Strand - Eelke Kleijn
Help Me Lose My Mind (Feat. London Grammar) - Disclosure
Sun Goes Down (Feat. Jasmine Thompson) - Robin Schulz
I Got U (Feat. Jax Jones) - Duke Dumont
Sonnentanz (Sun Don't Shine) (Feat. Will Heard) - Klangkarussell
See Right Through (Feat. Fiora) - Tensnake
Close To You - Maxi Priest
Forget I Was A ''G'' - Whitehead Bros
Come Baby Come - K7
Don't Walk Away - Jade
My Prerogative - Bobby Brown
Heard It All Before (Radio Version W/o Intro) - Sunshine Anderson
Dance With Me - 112
Family Affair - Mary J. Blige
Never Leave You - Uh Ooh, Uh Oooh! (Main) - Lumidee
American Boy (No Rap Version) - Estelle
Dip It Low - Christina Milian
Shoulda Woulda Coulda - Beverley Knight
Let Me Love You (Until You Learn To Love Yourself) - Ne-Yo
Don't Hold Your Breath (Main Version) - Nicole Scherzinger
Take me home - Lopazz
Gotta Know - Catz N Dogz
Downtown - Italoboyz
Poison - RITA ORA
Right Here - Jess Glynne
Heartbeat Song - Kelly Clarkson
Elastic Heart - Sia
Body Talk - Foxes
L.A. Love (lala) - Fergie
I Don't Care - Cheryl
Cool Kids - Echosmith
I Loved You - Blonde feat. Melissa Steel
Roar - Katy Perry
Doing It - Charli XCX feat. RITA ORA
Try - P!nk
Your Love - Nicole Scherzinger
Girl on Fire - Alicia Keys
Solo Dancing - Indiana
We R Who We R - Ke$ha
Love Again - Rae Morris
I Can't Describe (The Way I Feel) - Jennifer Hudson
I Bet - Ciara
Come On Over - Royal Blood
Epic - Faith No More
Mrs. Robinson - The Lemonheads
Just - Radiohead
Silver Machine - Hawkwind
Red Flag - Billy Talent
Burn It To The Ground - Nickelback
No More Heroes (1996 Remastered Version) - The Stranglers
I Wanna Be Sedated - Ramones
Dancing With Myself - The Donnas
Run Run Run - Jo Jo Gunne
To Be With You - Mr. Big
Fall from Grace - Babyshambles
See No Evil - Television
Too Much, Too Young, Too Fast - Airbourne
Don't You Want Me (2012 Remastered Version) - The Human League
Echo Beach - Martha & The Muffins
April Skies - The Jesus And Mary Chain
The Look Of Love - ABC
Stand - R.E.M.
Respect - Adeva
International Rescue - Fuzzbox
Everywhere - Fleetwood Mac
Can I Get A Witness - Dusty Springfield
In The Midnight Hour - Wilson Pickett
What Becomes Of The Broken Hearted - Jimmy Ruffin
As Long As I've Got You - The Charmels
Jimmy Mack - Martha & The Vandellas
The Rubberband Man (Single Version) - Spinners
Body Talk - Dimitri Vegas & Like Mike vs Ummet Ozcan
You Know - Zeds Dead & Oliver Heldens
The Hum - Dimitri Vegas & Like Mike vs Ummet Ozcan
Flute - New World Sound & Thomas Newson
Who Is Ready to Jump - Chuckie
Somebody to Love - Mr. Belt & Wezol & Freejak
Get Low - Dillon Francis & DJ Snake
Rubber - Curbi
Dirty - DJ S.K.T.
Chase Your Trip (Feat. Max Marshall) - Illyus & Barrientos
Sensation - Antonio Giacca
Look What They Done To My Song Ma (Billie Jo Spears)
El Paso (Marty Robbins)
Standing Room Only (Chet Akins)
Track 12
Track 13
Track 17
Track 10
He's A Tramp - Peggy Lee
Let's Jump The Broomstick - Brenda Lee
Everybody's Somebody's Fool - Connie Francis
Firestone - Kygo feat. Conrad Sewell
Scream (Funk My Life Up) - Paolo Nutini
Something I Need - Ben Haenow
Holding On - Julio Bashmore feat. Sam Dew / Inner Life
Wet Dollars - Tazer x Tink
Drop That Kitty (Feat. Charli XCX & Tinashe) - Ty Dolla $ign
Real (Feat. Yasmin) - Gorgon City
SUMMER IN THE CITY - THE APPLES
BOOGIE WONDERLAND - AIR LOVERS
FLASHDANCE (WHAT A FEELING) - ABSOLUTELY FANTASTIC
DISCO INFERNO - AIR LOVERS
IT NEVER RAINS IN SOUTHERN CALIFORNIA - AIR LOVERS
LIKE A VIRGIN - ABSOLUTELY FANTASTIC
WE BUILT THIS CITY - ABSOLUTELY FANTASTIC
YOU CAN T HURRY LOVE - ATTRACTION
UPSIDE DOWN - DANCETERIA
EVERY BREATH YOU TAKE - ABSOLUTELY FANTASTIC
WILD THING - A HARD MOUNTAIN
LARGER THAN LIFE - CLUELESS
BE WITH YOU - ANTONIO ASCOLINO
HOLIDAY - ABSOLUTELY FANTASTIC
THAT DON T IMPRESS ME MUCH - ASTONISHED (
FOLLOW ME - CLUELESS
Weezer - Buddy Holly
Fountains Of Wayne - Stacy's Mom
Fall Out Boy - Sugar, We're Goin Down
American Hi-Fi - Flavor Of The Weak
Alien Ant Farm - Smooth Criminal
Papa Roach - Last Resort
The Rasmus - In The Shadows
Andrew WK - Party Hard
Puddle Of Mudd - She Hates Me
Bloodhound Gang - The Bad Touch
Sublime - Santeria
The Dandy Warhols - Bohemian Like You
John Leyton - Johnny Remember Me
Manfred Mann - Fox On The Run
The Fortunes - Storm In A Teacup
Keith West - Excerpt From A Teenage Opera
The Monkees - Daydream Believer
Cat Stevens - The First Cut Is The Deepest
Dave Berry - Memphis Tennessee
The Tremeloes - Here Comes My Baby
The Foundations - In the Bad, Bad Old Days (Before You Loved Me)
The Archies - Sugar Sugar
Status Quo - Pictures of Matchstick Men
The Animals - We've Gotta Get Out of This Place
Steppenwolf - Born To Be Wild
Crazy World Of Arthur Brown - Fire
Jeff Beck - Hi Ho Silver Lining
Donovan - Sunshine Superman
Crystal Waters - Gypsy Woman (She's Homeless)
Cathy Dennis - Touch Me (All Night Long)
Cece Peniston - Finally
Livin' Joy - Dreamer
Nightcrawlers - Push the Feeling On
Wild Child - Renegade Master
The Lisa Marie Experience - Keep On Jumpin'
The Tamperer - Feel It (feat Maya)
Room 5 - Make Luv (feat Oliver Cheatham)
Brothers In Rhythm - Such A Good Feeling
David Guetta vs The Egg - Love Don't Let Me Go (Walking Away)
Moony - Dove (I'll Be Loving You)
That's the Way (I Like It) - KC & The Sunshine Band
Twenty Five Miles - Edwin Starr
Thank You (Falettinme Be Mice Elf Agin) - Sly & The Family Stone
Parrty, Pt.1 - Maceo & The Macks
The Snake - Al Wilson
Papa's Got a Brand New Bag - Georgie Fame
I Just Dropped In - Sharon Jones & the Dap-Kings
The Man - Omar
Fish in the Sea - Frootful feat. Angeline Morrison
Wait a Minute - The Excitements
Money - Lady
Everything's Better in the Summertime - Nick Pride & The Pimptones
You Make My Dreams (Come True) - Hall & Oates
Can You Feel The Force - The Real Thing
I'm Walking On Sunshine - Katrina And The Waves
Build Me Up Buttercup - The Foundations
Young Gifted And Black - Bob & Marcia
Pushin On - The Quantic Soul Orchestra Feat Alice Russell
Back To Life (However Do You Want Me) - Soul II Soul featuring Caron Wheeler
Break Of Dawn - Rhythm On The Loose
Saturday Night, Sunday Morning - T-EMPO ft. Juliet Roberts
The Time Warp
Little Shop Of Horrors
The Purple People Eater
Witch Doctor
I Put A Spell On You
Monster Mash - Justin Fletcher
Lovestation/Storm Queen - Teardrops/Look Right Through (acapella)
Oliver $ & Jimi Jules/ DJ Innocence - Pushing On/So Beautiful
Tchami/Nightcrawlers vs DJ S.K.T - Promesses/Push The Feeling On 2014 (feat kaleem Taylor/acapella)
Wretch 32/Dennis Ferrer - Traktor/Hey Hey (feat L - Mike Delinquent Project Go Harder dub/acapella)
Paul JohnsonRosie Gaines - Get Get Down/Closer Than Close
Chris Malinchak/Jam Velvet - So Good To Me/Show Me Love (instrumental)
Peter Brown/Genius Cru - G Dancer/Boom Selection (acapella)
Sigala/Indeep/The Cut Up Boys - Easy Love/Last Night A DJ Saved My Life/Sahara (acapella)
Shirley Ellis - Soul Time
Bernie Williams - Ever Again
Beverly Ann - He's Coming Home
Larry Williams - A Quitter Never Wins
Percy Wiggins - It Didn't Take Much (For Me To Fall In Love)
Bob Brady & The Con Chords - Everybody's Goin' To The Love
Herb Ward - Honest To Goodness
The Carstairs - He Who Picks A Rose
Ujima - I'm Not Ready
Bobby Womack & The Brotherhood - Home Is Where The Heart Is
Sandi Sheldon - You're Gonna Make Me Love You
Little Richard - A Little Bit Of Something (Beats A Whole Lot Of Nothing)
Patti Austin - Are We Ready For Love
Sexy and I Know It - LMFAO
Grace Kelly - MIKA
We Are Young - Fun feat. Janelle Monáe
Timber - Pitbull feat. Ke$ha / Pitbull
If We Ever Meet Again - Timbaland feat. Katy Perry
Touch Me (All Night Long) - Cathy Dennis
All That She Wants - Ace Of Base
Pass The Dutchie - Musical Youth
U Sure Do - Strike
Change Of Heart - Change
Take That To The Bank - Shalamar
Sing It Back - Moloko
We Got The Funk - Positive Force
Swing Low, Sweet Chariot - Ella Eyre
John Newman - Come And Get It
Aloe Blacc - The Man
Leona Lewis - Fire Under My Feet
Tove Lo - Talking Body
The Weeknd - Can't Feel My Face
Cheryl - I Don't Care
Take That - These Days
Katy Perry - Roar
Ella Eyre - Good Times
American Authors - The Best Day Of My Life
Will Young - Love Revolution
Leftfield - Original
Sneaker Pimps - 6 Underground
Moloko - Fun For Me
Beats International - Dub Be Good To Me
Mr Natural - That Green Jesus
Morcheeba - Tape Loop
Kinobe - Slip Into Something More Comfortable
The Beloved - Hello
DNA feat Suzanne Vega - Tom's Diner
Doop (Sidney Berlin Ragtime Band) - Doop
The Way I Are - Timbaland -
Trick Me - Kelis
The Air That I Breathe - The Hollies
Mother and Child Reunion - Paul Simon
I Can Hear the Grass Grow - The Move
She's Not There - Santana
Suicide Is Painless (From the 20th Century-Fox film "M*A*S*H") - The Mash
I Can See Clearly Now - Johnny Nash
Je t'aime...Moi non plus - Jane Birkin & Serge Gainsbourg
Salt N Pepa - Push It
Come Home - James
Killer (Feat. Seal) - Adamski
Whirlpool (Crystal Design Reface) - Sergey Shabanov
Doppelganger - Mr. Pit vs Fisherman & Hawkins
World's Apart - Artisan
Stevie Wonder - 'Superstition'
Painter Man - The Creation
Stay With Me (2006 Remastered Version) - Faces
Make Me Smile (Come Up And See Me)  Steve Harley & Cockney Rebel
Peaches (1996 Remastered Version) - The Stranglers
The Prince (1999 Remastered Version) - Madness
Kiss From A Rose - Seal
Richard III - Supergrass
Waiting For Love - Avicii
Rio - Netsky Feat. Digital Farm Animals
Bring Me To Life - MK Feat. Milly Pye
Whisky Story - Example
The Jam - Kideko
I Love It (feat. Charli XCX) - Icona Pop
Overload - Sugababes
The Boy Does Nothing - Alesha Dixon
Fascination - Alphabeat
Remedy - Little Boots
Extraordinary (feat. Sharna Bass) - Clean Bandit
Wow - Kylie Minogue
Big When I Was Little - Eliza Doolittle
Kiss Kiss - Holly Valance
Stars Are Blind - Paris Hilton
Ain't Nobody - Jasmine Thompson
Royals - Lorde
Wicked Game - Fallulah
Real Love (Feat. Jess Glynne) - Clean Bandit
Dance with Me Tonight - Olly Murs
Try - Pink
Lady Marmalade - La Belle
Can't Take My Eyes Off Of You - Boys Town Gang
(I Never Promised You A) Rose Garden - Lynn Anderson
The Devil Went Down to Georgia - Charlie Daniels
Hell on Heels - Pistol Annies
Blue Monday '88 - New Order
Don't Leave Me This Way (with Sarah Jane Morris) - Communards
Geno - Dexy's Midnight Runners
Dancing With Tears In My Eyes - Ultravox
We Close Our Eyes - Go West
What Is Love? - Howard Jones
Ghost Town - The Specials
Kids In America - Kim Wilde
You Make Me Feel (Mighty Real) - Jimmy Somerville
Venus - Bananarama
Our Lips Are Sealed - Fun Boy Three
Good Tradition - Tanita Tikaram
Kokomo - The Beach Boys
What's the Colour of Money - Hollywood Beyond
Gloria - Laura Branigan
Cry Boy Cry - Blue Zoo
Next To Me - Otto Knows
Sugar (feat. Francesco Yates) - Robin Schulz
In The Year 2525 (Exordium & Terminus) - Zager & Evans
Good Morning Starshine - Lynn Kellogg, Melba Moore, James Rado and Gerome Ragni
Finders Keepers - Salt Water Taffy
Ain't Nobody (Loves Me Better) [feat. Jasmine Thompson] - Felix Jaehn
Together - The Magician
L.O.V.E. - Purple Disco Machine & Boris Dlugosch
Can't Stop Playing (Makes Me High) - Dr. Kucho!, Gregor Salto, Ane Brun
Firestone - Kygo, Conrad
Two Minds - Nero
Heroes (We Could Be) - Alesso, Tove Lo
I Want You To Know - Zedd, Selena Gomez
Go - The Chemical Brothers
Secrets - Tiësto, KSHMR, Vassy
You Know You Like It - AlunaGeorge
Liquid Spirit - Gregory Porter
Champagne Kisses - Jessie Ware
Come And Get It - John Newman
Bobby Vee - The Night Has A Thousand Eyes
Amen Corner - Bend Me Shape Me
Traffic - Hole In My Shoe
Frankie Valli & The Four Seasons - Rag Doll
Herman's Hermits - No Milk Today
The Monkees - I'm A Believer
Peroxide Swing - Michael Buble
Too Close For Comfort - Jamie Cullum
Can't Take My Eyes Off You - Engelbert Humperdinck
Gorgon City Feat. Katy Menditta - Imagination
Low Steppa Feat. Kelli Leigh - So Real
Nora En Pure - U Got My Body
Enzo Siffredi - Sometimes
M - 22
Kokiri - Turn Back Time (Retrospect)
Avicii - Waiting For Love
Alesso Feat. Roy English - Cool (Full Version)
Axwell & Ingrosso - Sun Is Shining
KSHMR & Tiësto Feat. Vassy - Secrets
A - Trak Feat. Andrew Wyatt
Zeds Dead & Oliver Heldens - You Know
Eurythmics - Sweet Dreams (Are Made Of This)
ABC - The Look Of Love
Wham! - Wake Me Up Before You Go-Go
Irene Cara - Fame
Kylie Minogue - I Should Be So Lucky
Jason Donovan - Too Many Broken Hearts
Yazz & The Plastic Population - The Only Way Is Up
Nik Kershaw - I Won't Let The Sun Go Down On Me
The Vamps - Wake Up
Nick Jonas - Levels
Jess Glynne - Hold My Hand
5 Seconds Of Summer - She's Kinda Hot
Hailee Steinfield - Love Myself
Ariana Grande - One Last Time
The Score - Oh My Love
Zedd ft Selena Gomez - I Want You To Know
Tori Kelly - Should've Been Us
Lawson - Roads
R5 - All Night
Ross Lynch & Maia Mitchell - Best Summer Ever
Jasmine Thompson - Ain't Nobody (Loves Me Better)
Sigma ft Ella Henderson - Glitterball
Carly Rae Jepsen - Call Me Maybe
Jessie J - It's My Party
Lady Gaga - Born This Way
Ellie Goulding - Anything Could Happen
Selena Gomez - Come & Get It
Pixie Lott - All About Tonight
High School Musical Cast - We're All In This Together
S Club 7 - Don't Stop Movin'
Aqua - Barbie Girl
Wanna Do - Joe Weller (Feat Emil)
Rumour Mill - Rudimental (Feat Anne Marie And Will Heard)
Hula Hoop - OMI
A Horse with No Name - America
Baby I'm-A Want You - Bread
Spirit in the Sky - Norman Greenbaum
See My Baby Jive - Wizzard
20th Century Boy - T-Rex
Hit Me With Your Rhythm Stick - Ian Dury and the Blockheads
Pop Muzik - M
No More Heroes - The Stranglers
Oh Boy - Mud
Yes Tonight Josephine - Johnnie Ray
Earth Wind & Fire - Boogie Wonderland
Chaka Khan - Im Every Woman
Kool and the Gang - Ladies Night
Don Hartman - Relight My Fire
Stacy Lattisaw - Jump To The Beat
Phyllis Hyman - You Know How To Love Me
Eruption - I Cant Stand the Rain
You Make Me Feel (Mighty Real) - Sylvester
(Are You Ready) Do the Bus Stop - The Fatback Band
Do What You Wanna Do - T-Connection
I Love the Nightlife - Alicia Bridges
Let's All Chant - Michael Zager Band
(Shake Shake Shake) Shake Your Booty - KC & The Sunshine Band
Cuba - The Gibson Brothers
Duran Duran - Ordinary World
Cutting Crew - (I Just) Died In Your Arms
Rainbow - Since You Been Gone
Mike Oldfield - Moonlight Shadow
Twisted Sister - The Price
Lost Frequencis ft Janieck Devy - Reality
Yolanda Be Cool & D Cup - Soul Makossa (Money)
L'Tric - This Feeling
Zedd ft Jon Bellion - Beautiful Now
Pep & Rash - Red Roses
Duke Dumont - Ocean Drive
Oliver Heldens & Shaun Frank ft Delaney Jane - Shades Of Grey
Lucky Charmes - Skank
Dimitri Vegas, Moguai & Like Mike ft Julian Perretta - Body Talk (Mammoth)
Alesso ft Sirena - Sweet Escape
Afrojack ft Mike Taylor - Summerthing!
Hayden James - Something About You
DJ Snake & Alunageorge - You Know You Like It
Armin Van Buuren ft Mr Probz - Another You
Avicii - The Nights
Dr. Kucho! & Gregor Salto ft Ane Brun - Can't Stop Playing (Make Me High) (Oliver Heldens Vocal)
Ace Of Base - All That She Wants
Alishas Attic - I Am, I Feel
Blueboy - Remember Me
Wamdue Project - King Of My Castle
Sub Sub - Ain't No Love (Ain't No Use) (feat Melanie Williams)
Travis - Why Does It Always Rain On Me?
If I Were a Rich Man - Topol
All That Jazz - Chita Rivera Chicago Ensemble
Zed Bias - Neighbourhood
Tru Faith & Dub Conspiracy - Freak Like Me
Nu - Birth - Anytime
Ramsey & Fen Feat. Lynsey Moore - Love Bug
Gilbert O'Sullivan - Get Down
Middle Of The Road - Chirpy Chirpy Cheep Cheep
Sparks - This Town Ain't Big Enough For The Both Of Us
Tony Christie - I Did What I Did For Maria
Showaddywaddy - Under The Moon Of Love
Bob And Marcia - Young, Gifted And Black
Johnny Nash - I Can See Clearly Now
Don't Be So Hard On Yourself - Jess Glynne
On My Mind - Ellie Goulding
Wake Up - The Vamps
Celtic Woman - Orinoco Flow
Parra For Cuva ft Anna Naklab - Wicked Games
Copacabana (At the Copa) - Barry Manilow
Reet Petite - Jackie Wilson
Resurrection Shuffle - Ashton, Gardner & Dyke
That's Nice - Neil Christian
Dolly Parton - 9 to 5
Dolly Parton & Kenny Rogers - Islands In The Stream
Carrie Underwood - Before He Cheats
The Boys Are Back In Town - Thin Lizzy
Hi Ho Silver Lining - Jeff Beck
Chelsea Dagger - The Fratellis
Rather Be (feat. Jess Glynne) - Clean Bandit
Ride This Train (feat. Aniff Akinola) - Icarus
Jealous (I Ain't With It) - Chromeo
Never Been In Love (feat. Icona Pop) - Cobra Starship
Whistle (While You Work It) - Katy Tiz
Dirty Talk - Wynter Gordon
Take Me Home (feat. Bebe Rexha) - Cash Cash
Heroes - Mans Zelmerlow
Heartbeat Loud - Andy C & Fiora
Timber - Pitbull feat Keha Pitbull
Stronger (What Doesnt Kill You) - Kelly Clarkson
Kids Again - Example
Crying at the Discoteque - Alcazar
You Spin Me Round (Like a Record) - Dead Or Alive
Keep on Movin - Five
Word Up - Korn
Stop the Rock - Apollo 440
Dr Beat - Miami Sound Machine
Hey Ya - OutKast
Aint Got No I Got Life - Nina Simone vs Groovefinder
Stranger - Chris Malinchak Jerry Carr
Happiness - Alexis Jordan
Daddy Cool - Boney M
People Hold On (Bootleg Version) - Lisa Stansfield vs. The Dirty Rotten Scoundrels
Be Happy, (Jommes Tatz Radio Version) - Danny Cotrell Feat. Cvb
Joe Stone - The Party (This Is How We Do It) (feat Montell Jordan)
LO'99 & Marshall F - Take Me Back
MK - Bring Me To Life (feat Milly Pye)
Alex Metric - Drum Machine (feat The New Sins)
Amtrac - Hold On
XYconstant - Silverlined
The Party (This Is How We Do It) - Joe Stone Montell Jordan
Sunshine - Gabrielle
Tell Me Its Real - K-Ci And JoJo
Last Night A DJ Saved My Life - Seamus Haji KayJay
Call My Name - Cheryl
The Way I Are - Timbaland Keri Hilson DOE
Release Me - Agnes
From Paris To Berlin - Infernal
I Found U - Axwell MaxC
Dont Phunk With My Heart - The Black Eyed Peas
Safe Inside You - Armin van Buuren presents Rising Star feat Betsie
Ram Jam - Black Betty
The Byrds - Mr. Tambourine Man
Sweet - Ballroom Blitz
Alice Cooper - Poison
REO Speedwagon - Take It On The Run
Kansas - Carry On Wayward Son
Judas Priest - Better By You, Better Than Me
311 - Down
Al Stewart - Carol
Scorpions - In Trance
The Guess Who - No Time
I Smiled Yesterday - Dionne Warwick
Sigala Feat. Bryn Christopher - Sweet Lovin'
Galantis - Peanut Butter Jelly
Josh Parkinson - No More
Redlight - Lost In Your Love
Martin Solveig & GTA - Intoxicated
Rudimental - Waiting All Night
DJ Fresh Feat. Sian Evans - Louder
Years & Years - Shine
Alex Adair - Heaven
Gorgon City Feat. ROMANS - Saving My Life
Usher - Scream
Icona Pop ft Charli XCX - I Love It
Calvin Harris - Ready For The Weekend
Jennifer Lopez - Waiting For Tonight
KC & The Sunshine Band - Give It Up
Spotlight - Jennifer Hudson
Tonight Tonight - Hot Chelle Rae
Thinking About You - Calvin Harris feat Ayah Marar
Holding onto Heaven - Foxes
Dont Wanna Dance - M
I See You Baby - Groove Armada feat Gramma Funk
Budapest - George Ezra
Let Her Go - Passenger
Like An Arrow - Lucy Rose
Imagine Dragons - On Top Of The World
Electric Guest - This Head I Hold
Bros - When Will I Be Famous ?
Bananarama - Cruel Summer
The Blow Monkeys - It Doesn't Have To Be This Way
Fuzzbox - Pink Sunshine
Madness - House Of Fun
Sabrina - Boys (Summertime Love)
Fine Young Cannibals - She Drives Me Crazy
The Maisonettes - Heartache Avenue
The Belle Stars - The Clapping Song
Madness - Baggy Trousers
The Belle Stars - Sign Of The Times
Tenpole Tudour - Swords Of A Thousand Men
Jona Lewie - You'll Always Find Me In The Kitchen At Parties
Rita Ora - How We Do (Party)
Jennifer Lopez - Get Right
Ciara - Like A Boy
Jessica Mauboy - Burn
Natasha Beningfield - Single
Alexandra Burke - Broken Heels
Whitney Houston - Queen Of The Night
I Need a Dollar - Aloe Blacc
Touch - Pia Mia
Love Don't Let Me Go (Walking Away)  - David Guetta vs. The Egg]
Breakeven - The Script
Stay - Hurts
Teardrop - Newton Faulkner
Buster Poindexter - Hit The Road Jack
Train - Drive By
Cheap Trick - You Drive, I'll Steer
The Gun - Race With The Devil
Electric Light Orchestra - Livin' Thing
The Boo Radleys - Wake Up Boo!
Jefferson Airplane - Somebody To Love
Aretha Franklin - Freeway Of Love
Kenny Loggins - Danger Zone
The 5th Dimension - Up, Up And Away
Nina Simone - Ain't Got No / I Got Life
The Charlie Daniels Band - The Devil Went Down To Georgia
The Edgar Winter Group - Free Ride
Steppenwolf - Hard Rock Road
Teenage Dream - Katy Perry
Bananarama - Venus
Scissor Sisters - I Don't Feel Like Dancing
Sinitta - So Macho
Sylvester - You Make Me Feel (Mighty Real)
Damian - The Time Warp
Cher - Believe
Take That - Relight My Fire
Taylor Dayne - Tell It To My Heart
Evelyn Thomas - High Energy
Bobby Rydell - Forget Him
Brian Hyland - Ginny Come Lately
Del Shannon - (Maries The Name) His Latest Flame
Joe Brown And The Bruvvers - Thats What Love Will Do
Lesley Gore - You Dont Own Me
Heaven - Alex Adair
Rhythm of Auld (Feat. J'Danna) - Julio Bashmore
SOS - ABBA
Everything I Own - Ken Boothe
Seasons in the Sun - Terry Jacks
Id Like to Teach the World to Sing (In Perfect Harmony) - The New Seekers
Left Hand Free - Alt-J
Henrietta (single version) - The Fratellis
Farewell To The Fairground - White Lies
Pelican (album version) - The Maccabees
What You Know - Two Door Cinema Club
Heads Will Roll - Yeah Yeah Yeahs
5 Years Time - Noah & The Whale
What Will You Do (When The Money Goes)? - Milburn
Standing In The Way Of Control - The Gossip
Golden Skans - Klaxons
The Dark Of The Matinée - Franz Ferdinand
Banquet - Bloc Party
Are You Gonna Be My Girl? - Jet
Spread Your Love - Black Rebel Motorcycle Club
Bang Bang You're Dead - Dirty Pretty Things
In The Morning - Razorlight
Love It When You Call - The Feeling
Golden Retriever - Super Furry Animals
My Favourite Game - The Cardigans
Young Folks - Peter Bjorn & John
The Only One I Know - The Charlatans
Def Con One - Pop Will Eat Itself
Get Free - The Vines
Sale Of The Century - Sleeper
Can You Dig It? - The Mock Turtles
I'm Free - The Soup Dragons
The Size Of A Cow - The Wonder Stuff
World Shut Your Mouth - Julian Cope
The Passenger - Iggy Pop
Ready For Your Love - Gorgon City Featuring MNEK
Brokenhearted - Lawson
Anywhere For You - John Martin
Counting Stars OneRepublic
Wonderful - Angel
Ready or Not - Bridgit Mendler
All About Tonight - Pixie Lott
Something New - Girls Aloud
Put Your Hearts Up - Ariana Grande
Acapella - Kelis
I Like To Move It - Reel 2 Real Feat. The Mad Stuntman
Can't Get Enough - Soulsearcher
Remember Me - Blue Boy
What Is Love? - Haddaway
Fever - Peggy Lee
Sealed With a Kiss - Brian Hyland
Sweet Nothin's - Brenda Lee
Stupid Cupid - Connie Francis
Wonderous Place - Billy Fury
High & Dry - ABC
Human - Go West
Hot Stuff - Samantha Fox
Love Will Keep Us Together - Kim Wilde
Little Talks - Of Monsters and Men
Ship To Wreck - Florence The Machine
Kathleen - Catfish And The Bottlemen
Pedestrian At Best - Courtney Barnett
Cant Feel My Face - The Weeknd
Adventure Of A Lifetime - Coldplay
Lay It All On Me (feat Ed Sheeran) - Rudimental
Up (feat Demi Lovato) - Olly Murs
High By The Beach - Lana Del Rey
Lips Are Movin - Meghan Trainor
Love Revolution - Will Young
Domino - Jessie J
Heaven - Emeli Sandé
Everything To Me - Shane Filan
I Don't Feel Like Dancin'  - Scissor Sisters
Lovin' Each Day - Ronan Keating
Happy Together - The Turtles
Sugar and Spice - The Searchers
Even the Bad Times Are Good - The Tremeloes
A Groovy Kind of Love - The Mindbenders
Love Is All Around - The Troggs
For Your Love - The Yardbirds
Jennifer Eccles - The Hollies
Sugar Sugar - The Archies
Lovers of the World Unite - David and Jonathan
All I Really Want to Do - The Byrds
Baby, Now That I've Found You - The Foundations
Tossing and Turning - The Ivy League
Reality (Feat. Janieck Devy) - Lost Frequencies
Book of Love (Feat. Polina) - Felix Jaehn
Nightcall - KANT
Goodbye (Feat. Lyse) - Feder
Biology - Girls Aloud
I Think We're Alone Now - Tiffany
Dancing In The Street - Martha & The Vandellas
Son Of A Preacher Man - Dusty Springfield
The Look Of Love - Pt. 1 - ABC
Friday I'm In Love - The Cure
Lovefool - The Cardigans
Les Fleur - 4hero
F For You - Disclosure
Waiting All Night (feat Ella Eyre) - Rudimental Ella Eyre
Rather Be - Clean Bandit Jess Glynne
Im A Believer - The Monkees
Lets Stick Together - Bryan Ferry
The Look Of Love (Part 1) - ABC
Is There Something I Should Know - Duran Duran
Tainted Love - Soft Cell
Boombastic - Shaggy
Stuck In The Middle With You - Stealers Wheel
Like Clockwork - The Boomtown Rats
Trouble - Shampoo
Rock DJ - Robbie Williams
Rinse & Repeat (Feat. Kah-Lo) - Riton
Shades of Grey - Oliver Heldens
Book of Love - Felix Jaehn
Paths - CamelPhat & Redondo
Lost - Frequency & SoulCircuit
Always There - Alex Metric
That'll Be The Day - Buddy Holly
Susie Q - Dale Hawkins
Be Right There - Diplo & Sleepy Tom
Bring Me to Life (feat. Milly Pye) - MK
Peanut Butter Jelly - Galantis
Sun Is Shining - Axwell /\ Ingrosso
Manic Monday - The Bangles
You Don't Own Me - Grace
Up - Olly Murs Demi Lovato
Best Day Of My Life - American Authors
If We Ever Meet Again - Timbaland Katy Perry
Valerie - Amy Winehouse
I Really Like You - Carly Rae Jepsen
Fast Car - Jonas Blue Dakota
Can We Dance - The Vamps
Cool for the Summer - Demi Lovato
Aint Nobody (Loves Me Better) - Felix Jaehn Jasmine Thompson
Oh My Love - The Score
Love Machine - Girls Aloud
Born This Way - Lady Gaga
